46
16
24 0  0  0  0  0  0  0  0  0  0  0  0  0  0  0  0  0  0  0  0  0  0  0  0  0  0  0  0  0  0  0  0  0  0  22 23 27 27 27 27 27 27 27 27 23 
24 0  0  0  0  0  0  0  0  0  0  0  0  0  0  0  0  0  0  0  0  0  0  0  0  0  0  0  0  0  0  0  0  0  0  22 24 0  0  0  0  0  0  0  0  22 
24 0  0  0  0  0  0  0  0  0  0  0  0  0  0  0  0  0  0  0  0  0  0  0  0  0  0  0  0  0  0  0  0  0  0  22 24 0  0  0  0  0  0  0  0  22 
24 0  0  0  0  0  0  0  0  0  0  0  0  0  0  0  0  0  0  0  0  0  0  0  0  0  0  0  0  0  0  0  0  0  0  22 24 0  0  0  0  0  0  0  0  22 
24 0  0  5  0  0  0  0  3  4  10 0  0  0  0  0  0  0  0  0  0  0  0  0  0  0  0  0  0  0  0  0  0  0  0  22 24 0  0  0  0  0  0  0  0  22 
24 0  0  32 34 0  0  32 33 33 34 0  0  0  0  0  0  0  0  0  0  0  0  0  0  0  0  0  0  0  0  0  0  0  0  22 28 21 0  0  0  0  0  0  0  22 
24 0  0  0  0  0  0  0  0  0  10 0  0  0  0  0  0  0  0  10 2  0  0  0  0  0  0  0  0  0  0  0  0  0  0  22 24 0  0  0  0  0  0  0  0  22 
24 0  0  0  0  0  0  0  0  0  32 34 0  0  0  0  0  0  0  20 21 0  0  0  0  0  0  0  0  0  0  0  0  0  0  22 24 0  0  0  0  33 0  0  0  22 
24 0  0  0  0  10 0  8  9  0  0  0  0  0  0  0  0  0  0  23 24 0  0  0  0  0  0  0  0  0  0  10 0  0  0  30 31 0  0  0  0  0  0  0  0  22 
24 0  0  0  32 34 0  32 34 0  0  0  0  0  0  0  0  0  0  23 24 0  0  0  0  0  0  0  0  0  0  35 0  0  0  0  0  0  0  33 0  0  0  0  0  22 
24 0  6  0  10 0  0  0  5  0  0  0  0  0  10 7  0  0  0  23 24 7  0  0  19 21 0  10 0  0  10 37 0  10 0  0  0  0  0  0  0  10  0  0 10 22 
28 29 20 20 20 20 0  20 20 20 20 20 20 20 20 20 1  1  1  23 28 29 20 25 26 28 29 20 20 20 25 36 29 20 20 20 20 20 20 20 20 20 20 20 25 26 
23 23 23 23 23 23 0  23 23 23 23 23 23 23 23 23 38 38 38 23 23 23 23 23 23 23 23 23 23 23 23 23 23 23 23 23 23 23 23 23 23 23 23 23 23 23 
23 23 23 23 23 23 0  23 23 23 23 23 23 23 23 23 38 38 38 23 23 23 23 23 23 23 23 23 23 23 23 23 23 23 23 23 23 23 23 23 23 23 23 23 23 23 
23 23 23 23 23 23 39 23 23 23 23 23 23 23 23 23 38 38 38 23 23 23 23 23 23 23 23 23 23 23 23 23 23 23 23 23 23 23 23 23 23 23 23 23 23 23 
23 23 23 23 23 23 23 23 23 23 23 23 23 23 23 23 38 38 38 23 23 23 23 23 23 23 23 23 23 23 23 23 23 23 23 23 23 23 23 23 23 23 23 23 23 23
