108
42
24 0  0  0  0  0  0  0  0  0  0  0  0  0  0  0  0  0  0  0  0  0  0  0  0  0  0  0  0  0  0  0  0  0  0  0  0  0  0  0  0  0  0  0  0  0  0  0  0  0  0  0  0  0  0  0  0  0  0  0  0  0  0  0  0  0  0  0  0  0  0  0  0  0  0  0  0  0  0  0  0  0  0  0  0  0  0  0  0  0  0  0  0  0  0  0  0  0  0  0  0  0  0  0  0  0  0  22 
24 0  0  0  0  0  0  0  0  0  0  0  0  0  0  0  0  0  0  0  0  0  0  0  0  0  0  0  0  0  0  0  0  0  0  0  0  0  0  0  0  0  0  0  0  0  0  0  0  0  0  0  0  0  0  0  0  0  0  0  0  0  0  0  0  0  0  0  0  0  0  0  0  0  0  0  0  0  0  0  0  0  0  0  0  0  0  0  0  0  0  0  0  0  0  0  0  0  0  0  0  0  0  0  0  0  0  22 
24 0  0  0  0  0  0  0  0  0  0  0  0  0  0  0  0  0  0  0  0  0  0  0  5  2  0  0  0  0  0  0  0  0  0  0  0  0  0  0  0  0  0  0  0  0  0  0  0  0  0  0  0  0  0  0  0  0  0  0  0  0  0  0  0  0  0  0  0  0  0  0  0  0  0  0  0  0  0  0  0  0  0  0  0  0  0  0  0  0  0  0  0  0  0  0  0  0  0  0  0  0  0  0  0  0  0  22 
24 0  0  0  0  0  0  0  0  0  0  0  0  0  0  0  0  0  0  0  0  0  0  0  32 34 0  0  0  0  0  0  0  0  0  0  0  0  0  0  0  0  0  0  0  0  0  0  0  0  0  0  0  0  0  0  0  0  0  0  0  0  0  0  0  0  0  0  0  0  0  0  0  0  0  0  0  0  0  0  0  0  0  0  0  0  0  0  0  0  0  0  0  0  0  0  0  0  0  0  0  0  0  0  0  0  0  22 
24 0  0  0  0  0  0  0  0  0  0  0  0  0  0  0  0  0  0  10 0  33 0  0  0  0  0  0  0  0  0  0  0  0  0  0  0  0  0  0  0  0  0  0  0  0  0  0  0  0  0  0  0  0  0  0  0  0  0  0  0  0  0  0  0  0  0  0  0  0  0  0  0  0  0  0  0  0  0  0  0  0  0  0  0  0  0  0  0  0  0  0  0  0  0  0  0  0  0  0  0  0  0  0  0  0  0  22 
24 0  0  0  0  0  0  0  0  0  0  0  0  0  0  0  0  0  0  33 0  5  0  0  0  0  0  0  0  0  0  0  0  0  0  0  0  0  0  0  0  0  0  0  0  0  0  0  0  0  0  0  0  0  0  0  0  0  0  0  0  0  0  0  0  0  0  0  0  0  0  0  0  0  0  0  0  0  0  0  0  0  0  0  0  0  0  0  0  0  0  0  0  0  0  0  0  0  0  0  0  0  0  0  0  0  0  22 
24 0  0  0  0  0  0  0  0  0  0  0  0  0  0  0  0  0  0  0  0  33 0  0  0  0  0  0  0  0  0  0  0  0  0  0  0  0  0  0  0  0  0  0  0  0  0  0  0  0  0  0  0  0  0  0  0  0  0  0  0  0  0  0  0  0  0  0  0  3  4  10 0  0  0  10 0  8  9  0  0  0  0  0  0  0  0  2  0  10 0  8  9  0  0  5  0  10 0  0  10 0  3  4  0  0  0  22 
24 0  0  0  0  0  0  0  0  0  0  0  0  0  0  0  3  4  0  0  0  0  33 10 0  0  0  0  0  0  0  0  0  0  0  0  0  0  0  0  0  0  0  0  0  0  0  0  0  0  0  0  0  0  0  0  0  0  0  0  0  0  0  0  0  0  0  0  32 33 33 33 33 33 33 33 33 33 34 0  0  0  0  0  0  0  0  32 33 33 33 33 33 33 33 33 33 33 33 33 33 33 33 33 33 33 34 22 
24 0  0  0  0  0  0  0  0  0  0  0  0  0  0  0  32 34 0  0  0  0  0  33 0  0  0  0  0  0  0  0  0  0  0  0  0  0  0  0  0  0  0  0  0  0  10 2  0  0  0  0  0  0  0  0  0  0  0  0  0  0  0  0  0  0  0  0  0  0  0  0  0  0  0  0  0  0  0  0  0  0  0  0  0  0  0  0  0  0  0  0  0  0  0  0  0  0  0  0  0  0  0  0  0  0  0  22 
24 0  0  0  0  0  0  0  0  0  0  0  0  8  9  0  0  0  0  0  0  0  10 0  0  0  0  0  0  0  0  0  0  0  0  0  0  0  0  0  0  0  0  0  0  0  19 21 0  0  0  0  0  0  0  0  0  0  0  0  0  0  0  0  0  0  0  0  0  0  0  0  0  0  0  0  0  0  0  0  0  0  0  0  0  0  0  0  0  0  0  0  0  0  0  0  0  0  0  0  0  0  0  0  0  0  0  22 
24 0  0  0  0  0  0  0  0  0  0  0  0  32 34 0  0  0  0  0  0  0  32 34 0  0  0  0  0  0  0  0  0  0  0  0  0  0  0  0  0  0  0  0  10 0  22 24 0  0  0  0  0  0  0  0  0  0  0  0  0  0  0  0  0  0  0  0  0  0  0  0  0  0  0  0  0  0  0  0  0  0  0  0  0  0  0  0  0  0  0  0  0  0  0  0  0  0  0  0  0  0  0  0  0  0  0  22 
24 0  0  0  0  0  0  0  0  0  0  0  0  0  0  0  10 0  0  0  0  0  0  0  0  0  0  0  0  0  0  0  0  0  0  0  0  0  0  0  0  0  8  9  19 25 26 24 39 39 39 39 0  0  0  0  0  0  0  0  0  0  0  0  0  0  0  0  0  0  0  0  0  0  0  0  0  0  0  0  0  0  0  0  0  0  0  0  0  0  0  0  0  0  0  0  0  0  0  0  0  0  0  0  0  0  0  22 
24 0  0  0  0  0  0  0  0  0  0  0  0  0  0  0  32 34 0  0  0  0  0  0  0  0  0  0  0  0  0  0  0  0  0  0  0  0  0  0  5  10 19 25 26 23 23 28 26 23 23 24 39 39 0  0  0  0  0  0  0  0  0  0  0  0  0  0  0  0  0  0  0  0  0  0  0  0  0  0  0  0  0  0  0  0  0  0  0  0  0  0  0  0  0  0  0  0  0  0  0  0  0  0  0  0  0  22 
24 0  0  0  0  0  0  0  0  0  0  0  0  0  0  0  0  0  0  3  4  10 0  0  0  0  0  0  8  9  10 0  0  0  0  0  6  0  0  0  19 25 26 23 23 23 23 23 23 23 23 28 26 24 0  0  0  0  0  0  0  0  0  0  0  0  0  0  0  0  0  0  0  0  0  0  0  0  0  0  0  0  0  0  0  0  0  0  0  0  0  0  0  0  0  0  0  0  0  0  0  0  0  0  0  0  0  22 
24 0  0  0  0  0  0  0  0  0  0  0  0  0  0  0  0  0  0  32 33 34 0  0  0  0  0  0  32 33 34 0  0  0  0  0  19 21 0  0  22 23 23 23 23 23 23 23 23 23 23 23 23 24 39 39 0  0  0  0  0  0  0  0  0  0  0  0  0  0  0  0  0  0  0  0  0  0  0  0  0  0  0  0  0  0  0  0  0  0  0  0  0  0  0  0  0  0  0  0  0  0  0  0  0  0  0  22 
24 0  0  0  0  0  0  0  0  0  0  0  0  0  0  0  0  0  0  0  0  0  0  0  0  0  0  0  0  0  0  0  0  0  0  10 22 24 0  0  22 23 23 23 23 23 23 23 23 23 23 23 23 28 26 24 0  0  0  0  0  0  0  0  0  0  0  0  0  0  0  0  0  0  0  0  0  0  0  10 0  10 0  0  0  0  0  0  0  0  0  0  0  0  0  0  0  0  0  0  0  0  0  0  0  0  0  22 
24 0  0  0  0  0  0  0  0  0  0  0  0  0  0  0  0  0  0  0  0  0  0  0  0  0  0  0  0  0  0  0  0  0  0  19 26 24 0  0  22 23 23 23 23 23 23 23 24 0  0  22 23 23 23 24 39 39 0  0  0  0  0  0  0  0  0  0  0  0  0  0  0  5  10 0  0  0  32 33 33 33 34 0  0  0  0  0  0  0  0  0  0  0  0  0  0  10 3  4  0  0  0  0  0  0  0  22 
24 0  0  0  0  0  0  0  0  0  0  0  0  0  0  0  0  0  0  0  0  0  0  0  0  0  0  0  0  0  0  0  0  0  10 22 23 24 0  0  22 23 23 23 23 23 23 23 24 0  0  22 23 23 23 28 26 24 0  0  0  0  0  0  0  0  0  0  0  0  0  0  0  32 33 34 0  0  0  0  0  0  0  0  0  0  0  0  0  0  0  0  0  0  0  0  32 33 33 34 0  0  0  0  0  0  0  22 
24 10 0  3  4  0  0  0  0  0  0  0  0  0  0  0  0  0  0  0  0  0  0  0  0  0  0  0  0  0  0  0  0  0  19 26 23 24 0  0  22 23 23 23 23 27 27 27 31 0  0  30 27 27 27 27 27 24 0  0  0  0  0  0  0  0  0  0  0  10 0  0  0  0  0  0  0  0  0  0  0  0  0  0  0  0  0  0  0  0  0  0  0  0  0  0  0  0  0  0  0  0  0  0  0  0  0  22 
28 29 20 20 21 0  0  0  0  0  0  0  0  0  0  0  0  0  0  0  0  0  0  0  0  0  7  10 0  0  0  0  5  0  22 23 23 24 0  0  22 23 23 23 24 0  0  0  0  0  0  0  0  0  0  0  0  0  0  0  0  0  0  0  0  0  0  0  0  32 34 0  0  0  0  0  0  0  0  0  0  0  0  0  0  0  5  10 0  0  0  0  0  0  0  0  0  0  0  0  0  0  0  0  0  0  0  22 
23 23 23 23 24 10 7  0  0  0  0  0  0  0  0  0  0  0  0  0  0  0  0  0  0  0  19 20 20 1  1  1  20 25 26 23 23 24 0  0  22 23 23 23 24 0  0  7  0  0  0  0  7  0  0  0  0  0  0  0  0  0  0  0  0  0  0  0  0  0  0  0  0  32 34 0  0  0  32 34 0  0  0  0  0  32 33 34 0  0  0  0  0  32 34 0  0  0  0  0  0  0  0  0  0  0  0  22 
23 23 23 23 28 29 20 21 0  0  0  0  0  0  0  0  0  0  0  0  0  0  0  0  0  19 26 23 23 38 38 38 23 23 23 23 23 24 0  0  22 23 23 23 23 23 23 23 24 0  0  22 23 23 23 23 23 24 0  0  0  0  0  0  0  0  0  0  0  0  0  0  0  0  0  0  0  0  0  0  0  0  0  0  0  0  0  0  0  0  0  0  0  0  0  0  0  0  0  0  0  0  0  0  0  0  0  22 
23 23 23 23 23 23 23 24 6  10 5  0  0  0  0  0  0  0  0  0  0  0  0  0  19 26 23 23 23 38 38 38 23 23 23 23 23 24 0  0  22 23 23 23 23 23 23 23 23 23 23 23 23 23 23 23 23 24 39 39 0  0  0  0  0  0  0  0  0  0  0  0  0  0  0  0  0  0  0  0  0  0  0  0  0  0  0  0  0  0  0  0  0  0  0  0  0  0  0  0  0  0  0  0  0  0  0  22 
23 23 23 23 23 23 23 28 29 20 21 0  0  0  0  0  0  0  0  0  0  0  19 25 26 23 23 23 23 38 38 38 23 23 23 23 23 24 0  0  22 23 23 23 23 23 23 23 23 23 23 23 23 23 23 23 23 28 26 24 0  0  0  0  0  0  0  0  0  0  0  0  0  0  0  0  0  0  0  0  0  0  0  0  0  0  0  0  0  0  0  0  0  0  0  0  0  0  0  0  0  0  0  0  0  0  0  22 
23 23 23 23 23 23 23 23 23 23 24 0  3  4  10 0  7  0  0  0  0  10 22 23 23 23 23 23 23 38 38 38 23 23 23 23 23 24 0  0  22 23 23 23 23 23 23 23 23 23 23 23 23 23 23 23 23 23 23 24 0  0  0  0  0  0  0  0  0  0  0  0  0  0  0  0  0  0  0  0  0  0  0  0  0  0  0  0  0  0  0  0  0  0  0  0  0  0  0  0  0  0  0  0  0  0  0  22 
23 23 23 23 23 23 23 23 23 23 28 29 20 20 20 20 20 1  1  1  20 25 26 23 23 23 23 23 23 38 38 38 23 23 23 23 23 24 0  0  22 23 23 23 23 23 23 23 23 23 23 23 23 23 23 23 23 23 23 24 0  10 0  5  0  6  0  10 0  0  0  8  9  0  0  10 0  0  8  9  0  0  10 0  7  0  0  0  0  0  0  0  10 0  0  0  0  0  0  0  0  0  0  0  0  0  0  22 
23 23 23 23 23 23 23 23 23 23 23 23 23 23 23 23 23 38 38 38 23 23 23 23 23 23 23 23 23 38 38 38 23 23 23 23 23 24 0  0  22 23 23 23 23 23 23 23 23 23 23 23 23 23 23 23 23 23 23 28 29 20 20 20 20 20 20 20 21 0  0  19 20 20 20 20 20 20 20 20 20 20 20 20 20 20 1  1  1  1  1  1  35 1  1  1  1  1  1  1  1  1  1  1  1  1  1  26 
23 23 23 23 23 23 23 23 23 23 23 23 23 23 23 23 23 38 38 38 23 23 23 23 23 23 23 23 23 38 38 38 23 23 23 23 23 24 0  0  22 23 23 23 23 23 23 23 23 23 23 23 23 23 23 23 23 23 23 23 23 23 23 23 23 23 23 23 24 0  0  22 23 23 23 23 23 23 23 23 23 23 23 23 23 23 38 38 38 38 38 38 36 38 38 38 38 38 38 38 38 38 38 38 38 38 38 23 
23 23 23 23 23 23 23 23 23 23 23 23 23 23 23 23 23 38 38 38 23 23 23 23 23 23 23 23 23 38 38 38 23 23 23 23 23 24 0  0  22 23 23 23 23 23 23 23 23 23 23 23 23 23 23 23 23 23 23 23 23 23 23 23 23 23 23 23 24 39 39 22 23 23 23 23 23 23 23 23 23 23 23 23 23 23 38 38 38 38 38 38 23 38 38 38 38 38 38 38 38 38 38 38 38 38 38 23 
23 23 23 23 23 23 23 23 23 23 23 23 23 23 23 23 23 38 38 38 23 23 23 23 23 23 23 23 23 38 38 38 23 23 23 23 23 24 0  0  30 27 27 27 27 27 27 27 27 27 27 27 27 27 27 27 27 27 27 27 27 27 27 27 27 27 27 27 27 27 27 27 27 27 27 27 27 27 27 27 27 27 27 27 27 23 38 38 38 38 38 38 23 38 38 38 38 38 38 38 38 38 38 38 38 38 38 23 
23 23 23 23 23 23 23 23 23 23 23 23 23 23 23 23 23 38 38 38 38 38 38 38 38 38 38 38 38 38 38 38 38 38 38 38 38 24 0  0  0  0  0  0  0  0  0  0  0  0  0  0  0  0  0  0  0  0  0  0  0  0  0  0  0  0  0  0  0  0  0  0  0  0  0  0  0  0  0  0  0  0  0  0  0  22 38 38 38 38 38 38 27 38 38 38 38 38 38 38 38 38 38 38 38 38 38 23 
23 23 23 23 23 23 23 23 23 23 23 23 23 23 23 23 23 38 38 38 38 38 38 38 38 38 38 38 38 38 38 38 38 38 38 38 38 24 0  0  0  0  0  0  0  0  0  0  0  0  0  0  0  0  0  0  0  0  0  0  0  0  0  0  0  0  0  0  0  0  0  0  0  0  0  0  0  0  0  0  0  0  0  0  0  22 38 38 38 38 38 38 38 38 38 38 38 38 38 38 38 38 38 38 38 38 38 23 
23 23 23 23 23 23 23 23 23 23 23 23 23 23 23 23 23 38 38 38 38 38 38 38 38 38 38 38 38 38 38 38 38 38 38 38 38 24 0  0  0  0  0  0  0  0  0  0  0  0  0  0  0  0  0  0  0  0  0  0  0  0  0  0  0  0  0  0  0  0  0  0  0  0  0  0  0  0  0  0  0  0  0  0  0  22 38 38 38 38 38 38 38 38 38 38 38 38 38 38 38 38 38 38 38 38 38 23 
23 23 23 23 23 23 23 23 23 23 23 23 23 23 23 23 23 38 38 38 38 38 38 38 38 38 38 38 38 38 38 38 38 38 38 38 38 24 0  0  0  0  0  0  0  0  0  0  0  0  0  0  0  0  0  0  0  0  0  0  0  0  0  0  0  0  0  0  0  0  0  0  0  0  0  0  0  0  0  0  0  0  0  0  0  22 38 38 38 38 38 38 38 38 38 38 38 38 38 38 38 38 38 38 38 38 38 23 
23 23 23 23 23 23 23 23 23 23 23 23 23 23 23 23 23 38 38 38 38 38 38 38 38 38 38 38 38 38 38 38 38 38 38 38 38 24 0  0  0  0  0  35 0  0  0  0  0  0  35 0  0  0  0  0  0  0  35 0  0  0  0  0  0  35 0  0  0  0  0  0  35 0  0  0  0  0  35 0  0  0  0  0  0  22 38 38 38 38 38 38 38 38 38 38 38 38 38 38 38 38 38 38 38 38 38 23 
23 23 23 23 23 23 23 23 23 23 23 23 23 23 23 23 23 38 38 38 38 38 38 38 38 38 38 38 38 38 38 38 38 38 38 38 38 24 0  0  0  0  0  0  0  0  0  0  0  0  0  0  0  0  0  0  0  0  0  0  0  0  0  0  0  0  0  0  0  0  0  0  0  0  0  0  0  0  0  0  0  0  0  0  0  22 38 38 38 38 38 38 38 38 38 38 38 38 38 38 38 38 38 38 38 38 38 23 
23 23 23 23 23 23 23 23 23 23 23 23 23 23 23 23 23 23 23 23 23 23 23 23 23 23 23 23 23 23 23 23 23 23 23 23 23 28 29 20 20 20 20 20 20 20 20 20 20 20 20 20 20 20 20 20 20 20 20 20 20 20 20 20 20 20 20 20 20 20 20 20 20 20 20 20 20 20 20 20 20 20 20 20 25 26 38 38 38 38 38 38 38 38 38 38 38 38 38 38 38 38 38 38 38 38 38 23 
23 23 23 23 23 23 23 23 23 23 23 23 23 23 23 23 23 23 23 23 23 23 23 23 23 23 23 23 23 23 23 23 23 23 23 23 23 23 23 23 23 23 23 23 23 23 23 23 23 23 23 23 23 23 23 23 23 23 23 23 23 23 23 23 23 23 23 23 23 23 23 23 23 23 23 23 23 23 23 23 23 23 23 23 23 23 38 38 38 38 38 38 38 38 38 38 38 38 38 38 38 38 38 38 38 38 38 23 
23 23 23 23 23 23 23 23 23 23 23 23 23 23 23 23 23 23 23 23 23 23 23 23 23 23 23 23 23 23 23 23 23 23 23 23 23 23 23 23 23 23 23 23 23 23 23 23 23 23 23 23 23 23 23 23 23 23 23 23 23 23 23 23 23 23 23 23 23 23 23 23 23 23 23 23 23 23 23 23 23 23 23 23 23 23 38 38 38 38 38 38 38 38 38 38 38 38 38 38 38 38 38 38 38 38 38 23 
23 23 23 23 23 23 23 23 23 23 23 23 23 23 23 23 23 23 23 23 23 23 23 23 23 23 23 23 23 23 23 23 23 23 23 23 23 23 23 23 23 23 23 23 23 23 23 23 23 23 23 23 23 23 23 23 23 23 23 23 23 23 23 23 23 23 23 23 23 23 23 23 23 23 23 23 23 23 23 23 23 23 23 23 23 23 38 38 38 38 38 38 38 38 38 38 38 38 38 38 38 38 38 38 38 38 38 23 
23 23 23 23 23 23 23 23 23 23 23 23 23 23 23 23 23 23 23 23 23 23 23 23 23 23 23 23 23 23 23 23 23 23 23 23 23 23 23 23 23 23 23 23 23 23 23 23 23 23 23 23 23 23 23 23 23 23 23 23 23 23 23 23 23 23 23 23 23 23 23 23 23 23 23 23 23 23 23 23 23 23 23 23 23 23 38 38 38 38 38 38 38 38 38 38 38 38 38 38 38 38 38 38 38 38 38 23 
23 23 23 23 23 23 23 23 23 23 23 23 23 23 23 23 23 23 23 23 23 23 23 23 23 23 23 23 23 23 23 23 23 23 23 23 23 23 23 23 23 23 23 23 23 23 23 23 23 23 23 23 23 23 23 23 23 23 23 23 23 23 23 23 23 23 23 23 23 23 23 23 23 23 23 23 23 23 23 23 23 23 23 23 23 23 23 23 23 23 23 23 23 23 23 23 23 23 23 23 23 23 23 23 23 23 23 23 
