101
72
23 23 23 23 23 23 23 23 23 23 23 23 23 23 23 23 23 23 23 23 23 23 23 23 23 23 23 23 23 23 23 23 23 23 23 23 23 23 23 23 23 23 23 23 23 23 23 23 23 23 23 23 23 23 23 23 23 23 23 23 23 23 23 23 23 23 23 23 23 23 23 23 23 23 23 23 23 23 23 23 23 23 23 23 23 23 23 23 23 23 23 23 23 23 23 23 23 23 23 23 23 
23 23 23 23 23 23 23 23 23 23 23 23 23 23 23 23 23 23 23 23 23 23 23 23 23 23 23 23 23 23 23 23 23 23 23 23 23 23 23 23 23 23 23 23 23 23 23 23 23 23 23 23 23 23 23 23 23 23 23 23 23 23 23 23 23 23 23 23 23 23 23 23 23 23 23 23 23 23 23 23 23 23 23 23 23 23 23 23 23 23 23 23 23 23 23 23 23 23 23 23 23 
23 23 23 23 23 23 23 23 23 23 23 23 23 23 23 23 23 23 23 23 23 23 23 23 23 23 23 23 23 23 23 23 23 23 23 23 23 23 23 23 23 23 23 23 23 23 23 23 23 23 23 23 23 23 23 23 23 23 23 23 23 23 23 23 23 23 23 23 23 23 23 23 23 23 23 23 23 23 23 23 23 23 23 23 23 23 23 23 23 23 23 23 23 23 23 23 23 23 23 23 23 
23 23 23 23 23 23 23 23 23 23 23 23 23 23 23 23 23 23 23 23 23 23 23 23 23 23 23 23 23 23 23 23 23 23 23 23 23 23 23 23 23 23 23 23 23 23 23 23 23 23 23 23 23 23 23 23 23 27 27 27 27 27 27 27 27 27 27 27 27 27 27 27 27 27 27 27 27 27 27 27 27 27 27 27 27 27 27 27 27 27 27 27 27 27 27 27 27 27 27 27 23 
23 15 15 15 15 15 15 15 15 15 15 15 15 15 15 15 15 15 15 15 15 15 15 15 15 15 15 15 15 15 15 15 15 15 15 15 15 15 15 15 15 15 23 23 23 23 23 23 0  0  0  23 23 23 23 23 24 0  0  0  0  0  0  0  0  0  0  0  0  0  0  0  0  0  0  0  0  0  0  0  0  0  0  0  0  0  0  0  0  0  0  0  0  0  0  0  0  0  0  0  22 
23 15 15 15 15 15 15 15 15 15 15 15 15 15 15 15 15 15 15 15 15 15 15 15 15 15 15 15 15 15 15 15 15 15 15 15 15 15 15 15 15 15 23 23 23 23 23 23 23 23 0  23 23 23 23 23 24 0  0  0  0  0  0  0  0  0  0  0  0  0  0  0  0  0  0  0  0  0  0  0  0  0  0  0  0  0  0  0  0  0  0  0  0  0  0  0  0  0  0  0  22 
23 15 15 15 15 15 15 15 15 15 15 15 15 15 15 15 15 15 15 15 15 15 15 15 15 15 15 15 15 15 15 15 15 15 15 15 15 15 15 15 15 15 23 23 23 23 23 23 23 23 0  23 23 23 23 23 24 0  0  0  0  0  0  0  0  0  0  0  0  0  0  0  0  0  0  0  0  0  0  0  0  0  0  0  0  0  0  0  0  0  0  0  0  0  0  0  0  0  0  0  22 
23 15 15 15 15 15 15 15 15 15 15 15 15 15 15 15 15 15 15 15 15 15 15 15 15 15 15 15 15 15 15 15 15 15 15 15 15 15 15 15 15 15 23 23 23 23 23 23 0  0  0  23 23 23 23 23 24 0  0  0  0  0  0  0  0  0  0  0  0  0  0  0  0  0  0  0  0  0  0  0  0  0  0  0  0  0  0  0  0  0  0  0  0  0  0  0  0  0  0  0  22 
23 15 15 15 15 15 15 15 15 15 15 15 15 15 15 15 15 15 15 15 15 15 15 15 15 15 15 15 15 15 15 15 15 15 15 15 15 15 15 15 15 15 23 23 23 23 23 23 23 23 0  23 23 23 23 23 24 0  0  0  0  0  0  0  0  0  0  0  0  0  0  0  0  0  0  0  0  0  0  0  0  0  0  0  0  0  0  0  0  0  0  0  0  0  0  0  0  0  0  0  22 
23 15 15 15 15 15 15 15 15 15 15 15 15 15 15 15 15 15 15 15 15 15 15 15 15 15 15 15 15 15 15 15 15 15 15 15 15 15 15 15 15 15 23 23 23 23 23 23 23 23 0  23 23 23 23 23 24 0  0  0  0  0  0  0  0  0  0  0  0  0  0  0  0  0  0  0  0  0  0  0  0  0  0  0  0  0  0  0  0  0  0  0  0  0  0  0  0  0  0  0  22 
23 15 15 15 15 15 15 15 15 15 15 15 15 15 15 15 15 15 15 15 15 15 15 15 15 15 15 15 15 15 15 15 15 15 15 15 15 15 15 15 15 15 23 23 23 23 23 23 0  0  0  23 23 23 23 23 24 0  0  0  0  0  0  0  0  0  0  0  0  0  0  0  0  0  0  0  0  0  0  0  0  0  0  0  0  0  0  0  0  0  0  0  0  0  0  0  0  0  0  0  22 
23 15 15 15 15 15 15 15 15 15 15 15 15 15 15 15 15 15 15 15 15 15 15 15 15 15 15 15 15 15 15 15 15 15 15 15 15 15 15 15 15 15 23 23 23 23 23 23 23 23 23 23 23 23 23 23 24 0  0  0  0  0  0  0  0  0  0  0  0  0  0  0  0  0  0  0  0  0  0  0  0  0  0  0  0  0  0  0  0  0  0  0  0  0  0  0  0  0  0  0  22 
23 15 15 15 15 15 15 15 15 15 15 15 15 15 15 15 15 15 15 15 15 15 15 15 15 15 15 15 15 15 15 15 15 15 15 15 15 15 15 15 15 15 23 23 23 23 23 23 23 23 23 23 23 23 23 23 24 0  0  0  0  0  0  0  0  0  0  0  0  0  0  0  0  0  0  0  0  0  0  0  0  0  0  0  0  0  0  0  0  0  0  0  0  0  0  0  0  0  0  0  22 
23 15 15 15 15 15 15 15 15 15 15 15 15 15 15 15 15 15 15 15 15 15 15 15 15 15 15 15 15 15 15 15 15 15 15 15 15 15 15 15 15 15 23 23 23 23 23 23 23 23 23 23 23 23 23 23 24 0  0  0  0  0  0  0  0  0  0  0  0  0  0  0  0  0  0  0  0  0  0  0  0  0  0  0  0  0  0  0  0  0  0  0  0  0  0  0  0  0  0  0  22 
23 15 15 15 15 15 15 15 15 15 15 15 15 15 15 15 15 15 15 15 15 15 15 15 15 15 15 15 15 15 15 15 15 15 15 15 15 15 15 15 15 15 23 23 23 23 23 23 23 23 23 23 23 23 23 23 24 0  0  0  0  0  0  0  0  0  0  0  0  0  0  0  0  0  0  0  0  0  0  0  0  0  0  0  0  0  0  0  0  0  0  0  0  0  0  0  0  0  0  0  22 
23 15 15 15 15 15 15 15 15 15 15 15 15 15 15 15 15 15 15 15 15 15 15 15 15 15 15 15 15 15 15 15 15 15 15 15 15 15 15 15 15 15 23 23 23 23 23 23 23 23 23 23 23 23 23 23 24 0  0  0  0  0  0  0  0  0  0  0  0  0  0  0  0  0  0  0  0  0  0  0  0  0  0  0  0  0  0  0  0  0  0  0  0  0  0  0  0  0  0  0  22 
23 15 15 15 15 15 15 15 15 15 15 15 15 15 15 15 15 15 15 15 15 15 15 15 15 15 15 15 15 15 15 15 15 15 15 15 15 15 15 15 15 15 23 23 23 23 23 23 23 23 23 23 23 23 23 23 24 0  0  0  0  0  0  0  0  0  0  0  0  0  0  0  0  0  0  0  0  0  0  0  0  0  0  0  0  0  0  0  0  0  0  0  0  0  0  0  0  0  0  0  22 
23 15 15 15 15 15 15 15 15 15 15 15 15 15 15 15 15 15 15 15 15 15 15 15 15 15 15 15 15 15 15 15 15 15 15 15 15 15 15 15 15 15 23 23 23 23 23 23 23 23 23 23 23 23 23 23 24 0  0  0  0  0  0  0  0  0  0  0  0  0  0  0  0  0  0  0  0  0  0  0  0  0  0  0  0  0  0  0  0  0  0  0  0  0  0  0  0  0  0  0  22 
23 15 15 15 15 15 15 15 15 15 15 15 15 15 15 15 15 15 15 15 15 15 15 15 15 15 15 15 15 15 15 15 15 15 15 15 15 15 15 15 15 15 23 23 23 23 23 23 23 23 23 23 23 23 23 23 24 0  0  0  0  0  0  0  0  0  0  0  0  0  0  0  0  0  0  0  0  0  0  0  0  0  0  0  0  0  0  0  0  0  0  0  0  0  0  0  0  0  0  0  22 
23 15 15 15 15 15 15 15 15 15 15 15 15 15 15 15 15 15 15 15 15 15 15 15 15 15 15 15 15 15 15 15 15 15 15 15 15 15 15 15 15 15 23 23 23 23 23 23 23 23 23 23 23 23 23 23 24 0  0  0  0  0  0  0  0  0  0  0  0  0  0  0  0  0  0  0  0  0  0  0  0  0  0  0  0  0  0  0  0  0  0  0  0  0  0  0  0  0  0  0  22 
23 15 15 15 15 15 15 15 15 15 15 15 15 15 15 15 15 15 15 15 15 15 15 15 15 15 15 15 15 15 15 15 15 15 15 15 15 15 15 15 15 15 23 23 23 23 23 23 23 23 23 23 23 23 23 23 24 0  0  0  0  0  0  0  0  0  0  0  0  0  0  0  0  0  0  0  0  0  0  0  0  0  0  0  0  0  0  0  0  0  0  0  0  0  0  0  0  0  0  0  22 
23 15 15 15 15 15 15 15 15 15 15 15 15 15 15 15 15 15 15 15 15 15 15 15 15 15 15 15 15 15 15 15 15 15 15 15 15 15 15 15 15 15 23 23 23 23 23 23 23 23 23 23 23 23 23 23 24 0  0  0  0  0  0  0  0  0  0  0  0  0  0  0  0  0  0  0  0  0  0  0  0  0  0  0  0  0  0  0  0  0  0  0  0  0  0  0  0  0  0  0  22 
23 15 15 15 15 15 15 15 15 15 15 15 15 15 15 15 15 15 15 15 15 15 15 15 15 15 15 15 15 15 15 15 15 15 15 15 15 15 15 15 15 15 23 23 23 23 23 23 23 23 23 23 23 23 23 23 24 0  0  0  0  0  0  0  0  0  0  0  0  0  0  0  0  0  0  0  0  0  0  0  0  0  0  0  0  0  0  0  0  0  0  0  0  0  0  0  0  0  0  0  22 
23 15 15 15 15 15 15 15 15 15 15 15 15 15 15 15 15 15 15 15 15 15 15 15 15 15 15 15 15 15 15 15 15 15 15 15 15 15 15 15 15 15 23 23 23 23 23 23 23 23 23 23 23 23 23 23 24 0  0  0  0  0  0  0  0  0  0  0  0  0  0  0  0  0  0  0  0  0  0  0  0  0  0  0  0  0  0  0  0  0  0  0  0  0  0  0  0  0  0  0  22 
23 15 15 15 15 15 15 15 15 15 15 15 15 15 15 15 15 15 15 15 15 15 15 15 15 15 15 15 15 15 15 15 15 15 15 15 15 15 15 15 15 15 23 23 23 23 23 23 23 23 23 23 23 23 23 23 24 0  0  0  0  0  0  0  0  0  0  0  0  0  0  0  0  0  0  0  0  0  0  0  0  0  0  0  0  0  0  0  0  0  0  0  0  0  0  0  0  0  0  0  22 
23 15 15 15 15 15 15 15 15 15 15 15 15 15 15 15 15 15 15 15 15 15 15 15 15 15 15 15 15 15 15 15 15 15 15 15 15 15 15 15 15 15 23 23 23 23 23 23 23 23 23 23 23 23 23 23 24 0  0  0  0  0  0  0  0  0  0  0  0  0  0  0  0  0  0  0  0  0  0  0  0  0  0  0  0  0  0  0  0  0  0  0  0  0  0  0  0  0  0  0  22 
23 15 15 15 15 15 15 15 15 15 15 15 15 15 15 15 15 15 15 15 15 15 15 15 15 15 15 15 15 15 15 15 15 15 15 15 15 15 15 15 15 15 23 23 23 23 23 23 23 23 23 23 23 23 23 27 31 0  0  0  0  0  0  0  0  0  0  0  0  0  0  0  0  0  0  0  0  0  0  0  0  0  0  0  0  0  0  0  0  0  0  0  0  0  0  0  0  0  0  0  22 
23 15 15 15 15 15 15 15 15 15 15 15 15 15 15 15 15 15 15 15 15 15 15 15 15 15 15 15 15 15 15 15 15 15 15 15 15 15 15 15 15 15 15 15 15 15 15 15 15 15 15 15 15 15 15 0  0  0  0  0  0  0  0  0  0  0  0  0  0  0  0  0  0  0  0  0  0  0  0  0  0  0  0  0  0  0  0  0  0  0  0  0  0  0  0  0  0  0  0  0  22 
23 15 15 15 15 15 15 15 15 15 15 15 15 15 15 15 15 15 15 15 15 15 15 15 15 15 15 15 15 15 15 15 15 15 15 15 15 15 15 15 15 15 15 15 15 15 15 15 15 15 15 15 15 15 15 0  1  0  0  0  0  0  0  0  3  4  0  0  0  0  0  0  0  0  0  0  0  0  0  0  0  0  0  0  0  0  0  0  0  0  0  0  0  0  0  0  0  0  0  0  22 
23 20 20 20 20 20 20 20 20 20 20 20 20 20 20 20 20 20 20 20 20 20 20 20 20 20 20 20 20 20 20 20 20 20 20 20 20 20 20 20 20 20 20 20 20 20 20 20 20 20 20 20 20 20 20 20 21 0  0  0  0  0  0  0  35 0  0  0  0  0  0  0  0  0  0  0  0  0  0  0  0  0  0  0  0  0  0  0  0  0  0  0  0  0  0  0  0  0  0  0  22 
23 23 23 0  0  23 23 23 0  23 23 23 0  0  0  23 0  0  0  23 23 23 23 23 23 23 0  23 0  23 0  23 0  0  23 0  0  0  23 23 23 23 23 23 23 23 23 23 23 23 23 23 23 23 23 23 24 0  0  0  0  0  0  19 20 21 0  0  0  0  0  0  0  0  0  0  0  0  0  0  0  0  0  0  0  0  0  0  0  0  0  0  0  0  0  0  0  0  0  0  22 
23 23 23 0  23 23 23 0  23 0  23 23 23 0  23 23 0  23 0  23 23 23 0  23 23 23 23 0  23 23 0  23 0  23 23 0  23 0  23 23 23 23 23 23 23 23 23 23 23 23 23 23 23 23 23 23 24 0  0  0  0  0  19 20 20 20 21 0  0  0  0  0  0  0  0  0  0  0  0  0  0  0  0  0  0  0  0  0  0  0  0  0  0  0  0  0  0  0  0  0  22 
23 23 23 0  0  23 0  23 0  23 0  23 0  0  23 23 0  0  0  23 23 23 23 23 23 23 0  23 0  23 0  23 0  0  23 0  0  0  23 23 23 24 0  0  0  0  22 23 23 23 23 23 23 23 23 23 24 0  0  0  0  19 20 20 20 20 20 21 0  0  0  0  0  0  0  0  0  0  0  0  0  0  0  0  0  0  0  0  0  0  0  0  0  0  0  0  0  0  0  0  22 
23 23 23 23 23 23 23 23 23 23 23 23 23 23 23 23 23 23 23 23 23 23 23 23 23 23 23 23 23 23 23 23 23 23 23 23 23 23 23 23 23 24 0  0  0  0  22 23 23 23 23 23 23 23 23 23 24 0  0  0  19 20 20 20 20 20 20 20 21 0  0  0  0  0  0  0  0  0  0  0  0  0  0  0  0  0  0  0  0  0  0  0  0  0  0  0  0  0  0  0  22 
23 23 23 23 23 23 23 23 23 23 23 23 23 23 23 23 23 23 23 23 23 23 23 23 23 23 23 23 23 23 23 23 23 23 23 23 23 23 23 23 23 24 0  0  0  0  30 27 27 27 27 27 27 27 27 27 31 0  0  0  0  0  0  0  0  0  0  0  0  0  0  0  0  0  0  0  0  0  0  0  0  0  0  0  0  0  0  0  0  0  0  0  0  0  0  0  0  0  0  0  22 
23 23 23 23 23 23 23 23 23 23 23 23 23 23 23 23 23 23 23 23 23 23 23 23 23 23 23 23 23 23 23 23 23 23 23 23 23 23 23 23 23 24 0  0  0  0  0  2  0  0  0  0  0  0  0  0  0  0  0  0  0  0  0  0  0  0  0  0  0  0  0  0  0  0  0  0  0  0  0  0  0  0  0  0  0  0  0  0  0  0  0  0  0  0  0  0  0  0  0  0  22 
23 23 23 23 23 23 23 23 23 23 23 23 23 23 23 23 23 23 23 23 23 23 23 23 23 23 23 23 23 23 23 23 23 23 23 23 23 23 23 23 23 24 0  0  0  0  19 20 20 20 20 20 20 20 20 20 21 0  0  0  0  0  0  0  0  0  0  0  0  0  0  0  0  0  0  0  0  0  0  0  0  0  0  0  0  0  0  0  0  0  0  0  0  0  0  0  0  0  0  0  22 
23 23 23 23 23 23 23 23 23 23 23 23 23 23 23 23 23 23 23 23 23 23 23 23 23 23 23 23 23 23 23 23 23 23 23 23 23 23 23 23 23 24 0  0  0  0  22 23 23 23 23 23 23 23 23 23 24 0  0  0  0  0  0  0  0  0  0  0  0  0  0  0  0  0  0  0  0  0  0  0  0  0  0  0  0  0  0  0  0  0  0  0  0  0  0  0  0  0  0  0  22 
23 27 27 27 27 27 27 27 27 27 27 27 27 27 27 27 27 27 27 27 27 27 27 27 27 27 27 27 27 27 27 27 27 27 27 27 27 27 27 27 27 31 0  0  0  0  22 23 23 23 23 23 23 23 23 23 24 0  0  0  0  0  0  0  0  0  0  0  0  0  0  0  0  0  0  0  0  0  0  0  0  0  0  0  0  0  0  0  0  0  0  0  0  0  0  0  0  0  0  0  22 
24 0  0  0  0  0  0  0  0  0  0  0  0  0  0  0  0  0  0  0  0  0  0  0  0  0  0  0  0  0  0  0  0  0  0  0  0  0  0  0  0  0  0  0  0  0  22 23 23 23 23 23 23 23 23 23 24 0  0  0  0  0  0  0  0  0  0  0  0  0  0  0  0  0  0  0  0  0  0  0  0  0  0  0  0  0  0  0  0  0  0  0  0  0  0  0  0  0  0  0  22 
24 0  0  0  0  0  0  0  0  0  0  0  0  0  0  0  0  0  0  0  0  0  0  0  0  0  0  0  0  0  0  0  0  0  0  0  0  0  0  0  0  0  0  0  0  0  22 23 23 23 23 23 23 23 23 23 24 0  0  0  0  0  0  0  0  0  0  0  0  0  0  0  0  0  0  0  0  0  0  0  0  0  0  0  0  0  0  0  0  0  0  0  0  0  0  0  0  0  0  0  22 
24 0  0  0  0  0  0  0  0  0  0  0  0  0  0  0  0  0  0  0  0  0  0  0  0  2  0  11 0  0  12 13 0  9  10 0  0  0  0  0  0  0  0  0  0  0  22 23 23 23 23 23 23 23 23 23 24 0  0  0  0  0  0  0  0  0  0  0  0  0  0  0  0  0  0  0  0  0  0  0  0  0  0  0  0  0  0  0  0  0  0  0  0  0  0  0  0  0  0  0  22 
24 0  0  0  0  0  0  0  0  0  0  0  0  0  0  0  5  0  0  0  0  0  14 0  0  19 20 20 20 20 20 20 20 20 20 20 20 20 20 20 20 21 0  0  0  0  22 23 23 23 23 23 23 23 23 23 24 0  0  0  0  0  0  0  0  0  0  0  0  0  0  0  0  0  0  0  0  0  0  0  0  0  0  0  0  0  0  0  0  0  0  0  0  0  0  0  0  0  0  0  22 
24 0  0  0  0  0  0  0  0  0  0  0  0  0  0  32 34 0  0  0  0  0  33 0  0  22 23 23 23 23 23 23 23 23 23 23 23 23 23 23 23 24 0  0  0  0  22 23 23 23 23 23 23 23 23 23 24 0  0  0  0  0  0  0  0  0  0  0  0  0  0  0  0  0  0  0  0  0  0  0  0  0  0  0  0  0  0  0  0  12 13 0  0  0  0  0  0  0  0  0  22 
24 0  0  0  0  0  0  0  0  0  0  0  0  0  0  0  0  0  0  0  0  0  0  0  0  22 23 23 23 23 23 23 23 23 23 23 23 23 23 23 23 24 0  0  0  0  22 23 23 23 23 23 23 23 23 23 24 0  0  0  0  0  0  0  0  0  0  0  0  0  0  0  0  0  0  0  0  0  0  0  0  0  0  0  32 33 33 33 33 33 33 34 0  0  0  0  0  0  0  0  22 
24 0  0  0  0  0  0  0  0  0  0  0  0  0  0  0  0  33 0  0  0  0  8  5  0  22 23 23 23 23 23 23 23 23 23 23 23 23 23 23 23 24 0  0  0  0  22 23 23 23 23 23 23 23 23 23 24 0  0  0  7  5  0  0  0  0  0  0  12 13 0  0  0  0  0  0  0  0  0  0  0  0  0  0  0  0  0  0  0  0  0  0  0  0  0  0  0  32 34 0  22 
24 0  0  0  0  0  0  0  0  0  0  0  0  0  0  0  0  0  0  0  19 20 20 20 20 26 23 23 23 23 23 23 23 23 23 23 23 23 23 23 23 24 0  0  0  0  22 23 23 23 23 23 23 23 23 23 24 0  0  19 20 21 0  0  0  0  0  0  19 21 0  0  0  0  9  10 0  0  0  0  0  0  0  0  0  0  0  0  0  0  0  0  0  0  0  0  0  0  0  0  22 
24 6  0  0  0  0  0  0  0  0  0  0  0  3  4  0  6  0  0  7  22 23 23 23 23 23 23 23 23 23 23 23 23 23 23 23 23 23 23 23 23 24 0  0  0  0  22 23 23 23 23 23 23 23 23 23 24 0  0  22 23 24 0  0  0  0  0  0  30 31 0  0  0  0  19 21 0  0  0  0  0  0  0  0  0  0  0  0  0  0  0  0  0  0  0  0  0  0  0  32 26 
28 21 0  0  0  0  0  33 0  0  0  0  0  19 20 20 20 20 20 25 26 23 23 23 23 23 23 23 23 23 23 23 23 23 23 23 23 23 23 23 23 24 0  0  0  0  22 23 23 23 23 23 23 23 23 23 24 0  0  22 23 24 0  0  0  0  0  0  0  0  0  0  0  0  22 24 0  0  0  0  0  0  0  0  0  0  0  0  0  0  0  0  0  0  0  0  0  0  0  0  22 
23 24 7  0  0  0  0  0  0  0  0  0  0  30 27 27 27 27 27 27 27 27 27 27 27 23 23 23 23 23 23 23 23 23 23 23 23 23 23 23 23 24 0  0  0  0  22 23 23 23 23 23 23 23 23 23 24 0  0  22 23 24 0  0  0  0  0  0  0  0  0  0  0  0  22 24 0  0  0  0  0  0  0  0  0  0  0  0  0  0  0  0  0  0  0  35 0  0  0  0  22 
23 28 21 0  0  0  0  0  0  0  0  0  0  0  0  0  0  0  0  0  0  0  0  0  0  22 23 23 23 23 23 23 23 23 23 23 23 23 23 23 23 24 0  0  0  0  22 23 23 23 23 23 23 23 23 23 24 0  0  22 23 24 0  0  0  0  0  0  0  0  0  0  0  0  30 31 0  0  0  0  0  0  0  0  0  0  0  9  10 0  0  6  6  0  0  37 0  9  10 0  22 
23 23 24 8  0  0  0  0  0  0  0  0  0  0  0  0  0  0  0  0  0  0  0  0  0  22 23 23 23 23 23 23 23 23 23 23 23 23 23 23 23 24 0  0  0  0  22 23 23 23 23 23 23 23 23 23 24 0  0  30 27 31 0  0  0  0  0  0  0  0  0  0  0  0  0  0  0  0  0  0  0  0  0  0  0  0  19 20 20 20 20 20 20 20 25 36 29 20 20 20 26 
23 23 28 21 0  0  0  0  0  0  3  4  0  5  0  0  0  0  0  0  0  0  0  0  0  22 23 23 23 23 23 23 23 23 23 23 23 23 23 23 23 24 0  0  0  0  22 23 23 23 23 23 23 23 23 23 24 0  0  0  0  0  0  0  0  0  0  0  0  0  0  0  0  0  0  0  0  0  0  0  0  0  0  0  12 13 30 27 27 27 27 27 27 27 27 27 27 27 27 27 23 
23 27 27 31 0  0  0  32 33 33 33 33 33 33 33 34 0  0  0  0  0  0  0  0  0  22 23 23 23 23 23 23 23 23 23 23 23 23 23 23 23 24 0  0  0  0  22 23 23 23 23 23 23 23 23 23 24 0  0  0  0  0  0  0  0  5  0  0  0  0  0  3  4  7  0  0  0  0  0  0  0  0  0  0  32 34 0  0  0  0  0  0  0  0  0  0  0  0  0  0  22 
24 3  4  0  0  0  0  0  0  0  0  0  0  0  0  0  0  0  0  0  0  0  0  0  0  22 23 23 23 23 23 23 23 23 23 23 23 23 23 23 23 24 0  0  0  0  22 23 23 23 23 23 23 23 23 23 24 0  0  8  14 0  0  0  32 33 33 34 0  0  0  32 33 34 0  0  0  0  0  0  0  0  5  0  0  0  0  0  0  0  0  0  0  0  0  0  0  0  0  0  22 
28 29 20 20 21 0  0  0  0  0  0  0  0  0  0  0  0  0  0  0  0  0  0  0  0  22 23 23 23 23 23 23 23 23 23 23 23 23 23 23 23 24 0  0  0  0  22 23 23 23 23 23 23 23 23 23 24 0  0  32 34 0  0  0  0  0  0  0  0  0  0  0  0  0  0  0  0  0  0  0  0  32 33 34 0  0  0  5  8  0  0  0  0  0  0  0  0  0  0  0  22 
23 23 23 23 24 0  5  0  11 0  0  0  0  0  0  0  0  0  0  0  0  0  0  0  6  22 23 23 23 23 23 23 23 23 23 23 23 23 23 23 23 24 0  0  0  0  22 23 23 23 23 23 23 23 23 23 24 0  0  0  0  0  0  0  0  0  0  0  0  0  0  0  0  0  0  0  0  0  0  0  0  0  0  0  0  0  32 33 34 0  0  0  0  0  0  0  0  0  0  0  22 
23 23 23 23 28 29 20 20 20 21 0  0  14 0  0  0  0  0  0  3  4  0  0  0  32 26 23 23 23 23 23 23 23 23 23 23 23 23 23 23 23 24 0  0  0  0  22 23 23 23 23 23 23 23 23 23 24 0  0  0  0  0  0  0  0  0  0  0  0  0  0  0  0  0  0  0  0  0  0  0  0  0  0  0  0  0  0  0  0  0  0  7  14 0  0  0  0  14 6  0  22 
23 27 27 27 27 27 27 27 27 31 0  0  33 0  0  0  0  0  32 33 34 0  0  0  0  22 23 23 23 23 23 23 23 23 23 23 23 23 23 23 23 31 0  0  0  0  22 23 23 23 23 23 23 23 23 23 24 0  0  0  0  0  0  0  0  0  0  0  0  0  0  0  0  0  0  0  0  0  0  0  0  0  0  0  0  0  0  0  0  0  0  32 33 34 0  0  0  32 34 0  22 
24 0  0  0  0  0  0  0  0  0  0  0  0  0  0  0  0  0  0  0  0  0  0  7  0  22 23 23 23 23 23 23 23 23 23 23 23 23 23 23 24 0  0  0  0  0  22 23 23 23 23 23 23 23 23 23 24 0  0  0  0  0  0  0  0  0  0  0  0  0  0  0  0  0  0  0  0  0  0  0  0  0  0  0  0  0  0  0  0  0  0  0  0  0  0  0  0  0  0  8  22 
24 0  0  0  0  0  0  0  0  0  0  0  0  0  0  0  0  0  0  0  0  32 33 34 0  22 23 23 23 23 23 23 23 23 23 23 23 23 23 23 23 31 0  0  0  0  22 23 23 23 23 23 23 23 23 23 24 0  0  0  0  0  0  0  0  0  0  0  0  0  0  0  0  0  0  0  0  0  0  0  0  0  0  0  0  0  0  0  0  0  0  0  0  0  0  0  0  0  0  32 26 
24 2  0  0  0  0  0  0  0  0  0  0  0  0  6  0  0  0  0  0  8  0  0  0  0  22 23 23 23 23 23 23 23 23 23 23 23 23 23 23 24 0  0  0  0  0  22 23 23 23 23 23 23 23 23 23 24 0  0  0  0  0  0  0  0  0  0  0  0  0  0  0  0  0  0  0  0  0  0  0  0  0  0  0  0  0  0  0  0  0  0  0  0  0  0  0  0  0  8  0  22 
28 21 0  0  0  0  0  0  0  0  0  0  0  19 21 0  0  0  0  19 20 20 20 20 20 26 23 23 23 23 23 23 23 23 23 23 23 23 23 23 23 31 0  0  0  0  22 23 23 23 23 23 23 23 23 23 24 0  0  0  0  0  0  0  0  0  0  0  0  0  0  0  0  0  0  0  0  0  0  0  0  0  0  0  0  0  0  0  0  0  0  0  0  0  0  0  0  32 34 0  22 
23 24 0  8  0  11 0  0  3  4  0  7  0  22 24 0  0  0  0  22 23 23 23 23 23 23 23 23 23 23 23 23 23 23 23 23 23 23 23 23 24 0  0  0  0  0  22 23 23 23 23 23 23 23 23 23 24 0  0  0  0  0  0  0  0  0  0  0  0  0  0  0  0  0  0  0  0  0  0  0  0  0  0  0  0  0  0  0  0  0  0  0  0  0  0  0  8  0  0  0  22 
23 28 20 20 20 20 20 20 20 20 20 20 25 26 24 0  0  0  0  22 23 23 23 23 23 23 23 23 23 23 23 23 23 23 23 23 23 23 23 23 23 24 0  0  0  0  22 23 23 23 23 23 23 23 23 23 24 0  0  0  0  0  0  0  0  0  0  0  0  0  0  0  0  0  0  0  0  0  0  0  0  0  0  0  0  0  0  0  0  0  0  0  0  0  0  0  33 0  0  5  22 
23 23 23 23 23 23 23 23 23 23 23 23 23 23 24 0  0  0  0  22 23 23 23 23 23 23 23 23 23 23 23 23 23 23 23 23 23 23 23 23 23 24 0  0  0  0  22 23 23 23 23 23 23 23 23 23 24 0  0  0  0  0  0  0  0  0  0  0  0  0  0  0  0  0  0  0  0  0  0  0  0  0  0  0  0  0  0  0  0  0  0  0  0  0  0  0  0  0  0  32 26 
23 23 23 23 23 23 23 23 23 23 23 23 23 23 24 0  0  0  0  22 23 23 23 23 23 23 23 24 0  0  22 24 0  0  30 27 27 31 0  0  22 24 0  0  0  0  22 23 23 23 23 23 23 23 23 23 24 0  0  0  0  0  0  0  0  0  0  0  0  0  0  0  0  0  0  0  0  0  0  0  0  0  0  0  0  0  0  0  0  0  0  0  0  0  0  0  0  0  0  14 22 
23 23 23 23 23 23 23 23 23 23 23 23 23 23 24 0  0  0  0  30 27 27 27 27 27 27 27 31 0  0  30 31 0  0  0  0  0  0  0  0  30 31 0  0  0  0  30 27 27 27 27 27 27 27 27 27 31 0  0  0  0  0  0  0  0  0  0  0  0  0  0  0  0  0  0  0  0  0  0  0  0  0  0  0  0  0  0  0  0  0  0  0  0  0  0  0  0  0  0  32 26 
23 23 23 23 23 23 23 23 23 23 23 23 23 23 24 0  0  0  0  0  0  0  0  0  0  0  0  0  0  0  0  0  0  0  0  0  0  0  0  0  0  0  0  0  0  0  0  0  0  0  0  0  0  0  0  0  0  0  0  0  0  0  0  0  0  0  0  0  0  0  0  0  0  0  0  0  0  0  0  0  0  0  0  0  0  0  0  0  0  0  35 0  0  0  0  0  0  0  0  0  22 
23 23 23 23 23 23 23 23 23 23 23 23 23 23 24 0  0  0  0  0  11 0  6  0  0  6  0  0  0  0  0  8  0  0  0  0  0  0  0  0  8  6  0  0  0  0  2  0  0  0  0  0  0  0  0  0  0  0  0  0  0  0  0  0  0  0  0  0  0  0  0  0  0  0  0  0  0  0  0  0  0  0  0  0  0  35 0  0  0  0  37 0  0  0  0  0  0  0  0  32 26 
23 23 23 23 23 23 23 23 23 23 23 23 23 23 24 39 39 39 39 19 20 20 20 20 20 20 20 21 0  0  19 21 0  0  39 39 39 39 0  0  19 21 0  9  10 0  19 21 0  0  0  0  0  0  0  0  0  0  0  0  11 0  0  12 13 0  0  9  10 2  0  12 13 0  0  11 0  0  0  0  0  11 0  0  0  37 11 0  12 13 37 0  9  10 0  0  0  0  5  0  22 
23 23 23 23 23 23 23 23 23 23 23 23 23 23 28 29 20 20 25 26 23 23 23 23 23 23 23 28 29 25 26 28 29 20 20 20 20 20 20 25 26 28 29 20 20 25 26 28 29 20 20 20 20 20 20 20 20 20 20 20 20 20 20 20 20 20 20 20 20 20 20 20 20 20 20 20 20 20 20 20 20 20 20 20 25 36 29 20 20 25 36 29 20 20 20 20 20 20 20 25 26 
